Player,Pos,Age,Tm,G,GS,MP,FG,FGA,FG%,3P,3PA,3P%,2P,2PA,2P%,eFG%,FT,FTA,FT%,ORB,DRB,TRB,AST,STL,BLK,TOV,PF,PTS
Precious Achiuwa,C,23,TOR,12,0,245,36,92,.391,5,28,.179,31,64,.484,.418,28,33,.848,24,60,84,16,2,7,15,19,105
Steven Adams,C,29,MEM,22,22,596,77,129,.597,0,1,.000,77,128,.602,.597,19,62,.306,110,129,239,50,18,22,48,55,173
Bam Adebayo,C,25,MIA,22,22,772,176,335,.525,1,9,.111,175,326,.537,.527,103,118,.873,51,146,197,73,22,17,67,73,456
Ochai Agbaji,SG,22,UTA,8,0,72,10,21,.476,1,7,.143,9,14,.643,.500,4,7,.571,4,6,10,1,1,0,0,8,25
Santi Aldama,PF,22,MEM,23,16,581,83,180,.461,29,86,.337,54,94,.574,.542,27,38,.711,35,100,135,31,19,24,14,61,222
Nickeil Alexander-Walker,SG,24,UTA,15,0,158,22,56,.393,9,28,.321,13,28,.464,.473,8,9,.889,3,11,14,22,8,4,11,21,61
Grayson Allen,SG,27,MIL,20,18,540,67,147,.456,40,92,.435,27,55,.491,.592,43,47,.915,17,53,70,51,16,5,25,31,217
Jarrett Allen,C,24,CLE,17,17,544,94,160,.588,0,2,.000,94,158,.595,.588,41,52,.788,50,133,183,22,9,21,29,38,229
Jose Alvarado,PG,24,NOP,23,6,487,85,180,.472,38,94,.404,47,86,.547,.578,21,25,.840,10,45,55,77,27,4,31,51,229
Kyle Anderson,PF,29,MIN,18,3,398,42,85,.494,9,21,.429,33,64,.516,.547,23,28,.821,13,60,73,52,18,17,25,24,116
Giannis Antetokounmpo,PF,28,MIL,19,19,626,223,410,.544,15,63,.238,208,347,.599,.562,145,234,.620,39,176,215,104,16,20,70,65,606
Thanasis Antetokounmpo,SF,30,MIL,11,0,43,1,4,.250,0,1,.000,1,3,.333,.250,0,0,,2,9,11,2,0,2,4,3,2
Cole Anthony,PG,22,ORL,8,3,219,36,90,.400,11,32,.344,25,58,.431,.461,21,25,.840,4,32,36,28,10,4,11,27,104
OG Anunoby,SF,25,TOR,24,24,876,174,361,.482,38,111,.342,136,250,.544,.535,72,87,.828,35,103,138,52,56,21,63,72,458
Ryan Arcidiacono,PG,28,NYK,6,0,16,0,3,.000,0,2,.000,0,1,.000,.000,0,0,,0,2,2,2,2,0,1,2,0
Deni Avdija,SF,22,WAS,24,21,567,64,163,.393,18,68,.265,46,95,.484,.448,27,36,.750,22,99,121,55,17,17,33,74,173
Deandre Ayton,C,24,PHO,22,22,639,163,262,.622,4,13,.308,159,249,.639,.630,46,63,.730,63,148,211,47,11,19,42,64,376
Udoka Azubuike,C,23,UTA,9,0,35,7,8,.875,0,0,,7,8,.875,.875,2,6,.333,4,12,16,3,2,2,2,2,16
Marvin Bagley III,PF,23,DET,12,11,294,63,111,.568,7,19,.368,56,92,.609,.599,22,27,.815,28,54,82,8,10,8,15,29,155
Patrick Baldwin Jr.,SF,20,GSW,4,0,24,4,10,.400,2,8,.250,2,2,1.000,.500,0,0,,0,6,6,0,3,0,1,0,10
LaMelo Ball,PG,21,CHO,3,3,98,22,53,.415,10,32,.313,12,21,.571,.509,4,5,.800,0,11,11,21,3,1,11,8,58
Mo Bamba,C,24,ORL,19,5,355,57,119,.479,20,56,.357,37,63,.587,.563,22,31,.710,22,64,86,22,5,15,17,42,156
Paolo Banchero,PF,20,ORL,18,18,619,132,294,.449,16,65,.246,116,229,.507,.476,111,152,.730,23,99,122,68,14,11,53,39,391
Desmond Bane,SG,24,MEM,12,12,403,99,213,.465,46,102,.451,53,111,.477,.573,52,57,.912,6,53,59,57,7,3,27,29,296
Dalano Banton,PG,23,TOR,18,2,193,40,95,.421,13,41,.317,27,54,.500,.489,14,16,.875,8,20,28,22,11,10,12,21,107
Dominick Barlow,SF,19,SAS,3,0,22,2,6,.333,0,3,.000,2,3,.667,.333,4,4,1.000,2,1,3,3,1,0,0,3,8
Harrison Barnes,PF,30,SAC,22,22,674,90,184,.489,22,73,.301,68,111,.613,.549,89,106,.840,23,97,120,41,19,3,27,31,291
Scottie Barnes,PF,21,TOR,21,20,695,124,274,.453,26,81,.321,98,193,.508,.500,30,45,.667,37,106,143,104,20,19,53,34,304
RJ Barrett,SG,22,NYK,24,24,802,153,377,.406,37,131,.282,116,246,.472,.455,98,126,.778,22,107,129,71,12,2,55,54,441
Will Barton,SG,32,WAS,24,0,531,65,181,.359,26,82,.317,39,99,.394,.431,21,24,.875,6,68,74,61,15,7,24,28,177
Charles Bassey,C,22,SAS,14,0,214,33,48,.688,2,6,.333,31,42,.738,.708,10,18,.556,29,55,84,20,6,15,19,34,78
Keita Bates-Diop,SF,27,SAS,22,8,398,69,132,.523,11,30,.367,58,102,.569,.564,25,30,.833,27,38,65,16,13,4,17,15,174
Nicolas Batum,PF,34,LAC,25,1,467,39,94,.415,27,71,.380,12,23,.522,.559,11,19,.579,17,83,100,32,14,19,18,50,116
Darius Bazley,PF,22,OKC,18,0,280,38,87,.437,9,25,.360,29,62,.468,.489,14,28,.500,19,51,70,18,10,23,12,20,99
Bradley Beal,SG,29,WAS,18,18,631,156,299,.522,31,88,.352,125,211,.592,.574,69,79,.873,15,52,67,97,21,11,51,34,412
Malik Beasley,SG,26,UTA,26,2,690,123,301,.409,81,210,.386,42,91,.462,.543,18,20,.900,17,83,100,40,25,4,24,34,345
MarJon Beauchamp,SF,22,MIL,15,6,232,30,78,.385,12,41,.293,18,37,.486,.462,7,10,.700,14,30,44,6,7,2,18,26,79
Dāvis Bertāns,PF,30,DAL,9,0,64,9,24,.375,8,19,.421,1,5,.200,.542,3,4,.750,1,4,5,4,0,0,2,13,29
Patrick Beverley,PG,34,LAL,17,17,453,22,80,.275,12,54,.222,10,26,.385,.350,15,19,.789,12,55,67,43,14,8,15,51,71
Saddiq Bey,SF,23,DET,21,17,632,97,240,.404,30,112,.268,67,128,.523,.467,82,93,.882,24,74,98,36,16,4,27,37,306
Khem Birch,C,30,TOR,13,0,91,12,20,.600,1,1,1.000,11,19,.579,.625,2,2,1.000,6,8,14,4,4,2,4,17,27
Goga Bitadze,C,23,IND,14,0,142,21,39,.538,2,10,.200,19,29,.655,.564,9,18,.500,16,18,34,14,6,8,10,27,53
Bismack Biyombo,C,30,PHO,20,2,243,28,52,.538,0,0,,28,52,.538,.538,8,20,.400,18,49,67,16,6,28,21,36,64
Buddy Boeheim,PG,23,DET,1,0,1,0,0,,0,0,,0,0,,,0,0,,0,0,0,0,0,0,0,0,0
Bogdan Bogdanović,SG,30,ATL,2,0,45,8,22,.364,6,16,.375,2,6,.333,.500,0,0,,0,5,5,2,1,0,5,1,22
Bojan Bogdanović,PF,33,DET,24,24,759,165,325,.508,57,136,.419,108,189,.571,.595,107,122,.877,12,76,88,59,12,0,55,43,494
Bol Bol,PF,23,ORL,25,20,666,128,213,.601,19,46,.413,109,167,.653,.646,37,48,.771,33,154,187,25,12,46,53,37,312
Leandro Bolmaro,SG,22,UTA,4,0,23,2,7,.286,0,2,.000,2,5,.400,.286,0,0,,1,0,1,3,2,1,3,4,4
Devin Booker,SG,26,PHO,24,24,859,244,500,.488,57,146,.390,187,354,.528,.545,136,156,.872,20,97,117,142,24,10,61,64,681
Brandon Boston Jr.,SG,21,LAC,7,0,59,15,35,.429,7,11,.636,8,24,.333,.529,4,6,.667,3,4,7,3,2,0,3,3,41
Chris Boucher,PF,30,TOR,20,0,459,78,171,.456,17,60,.283,61,111,.550,.506,51,71,.718,46,79,125,13,16,16,15,50,224
James Bouknight,SG,22,CHO,19,0,327,38,113,.336,14,59,.237,24,54,.444,.398,10,16,.625,5,40,45,26,9,4,18,28,100
Tony Bradley,C,25,CHI,6,0,15,2,4,.500,1,2,.500,1,2,.500,.625,2,2,1.000,1,6,7,0,1,0,0,0,7
Malaki Branham,SF,19,SAS,11,2,188,21,64,.328,8,35,.229,13,29,.448,.391,8,10,.800,2,16,18,20,2,2,11,14,58
Christian Braun,SG,21,DEN,21,0,267,23,57,.404,7,20,.350,16,37,.432,.465,7,13,.538,13,30,43,15,8,3,6,19,60
Mikal Bridges,SF,26,PHO,24,24,876,147,285,.516,42,94,.447,105,191,.550,.589,48,54,.889,27,98,125,80,26,23,27,53,384
Oshae Brissett,SF,24,IND,19,0,302,33,77,.429,17,47,.362,16,30,.533,.539,22,30,.733,14,41,55,11,14,4,9,22,105
Malcolm Brogdon,PG,30,BOS,20,0,465,96,197,.487,38,77,.494,58,120,.483,.584,48,56,.857,20,63,83,74,11,4,38,30,278
Dillon Brooks,SG,27,MEM,21,21,658,138,350,.394,46,138,.333,92,212,.434,.460,45,60,.750,17,63,80,61,20,2,36,67,367
Bruce Brown,PG,26,DEN,23,11,690,103,218,.472,31,78,.397,72,140,.514,.544,21,24,.875,23,80,103,104,25,11,43,56,258
Greg Brown III,PF,21,POR,7,0,50,7,15,.467,1,5,.200,6,10,.600,.500,2,8,.250,1,6,7,0,3,4,3,7,17
Jaylen Brown,SF,26,BOS,23,23,826,228,452,.504,55,157,.350,173,295,.586,.565,104,125,.832,22,141,163,84,22,10,71,63,615
Kendall Brown,SG,19,IND,5,0,35,4,7,.571,0,1,.000,4,6,.667,.571,1,2,.500,2,4,6,3,3,0,1,6,9
Moses Brown,C,23,LAC,17,0,101,25,38,.658,0,0,,25,38,.658,.658,20,39,.513,17,27,44,1,1,6,4,16,70
Troy Brown Jr.,SF,23,LAL,19,16,486,58,128,.453,21,60,.350,37,68,.544,.535,11,11,1.000,18,71,89,19,15,1,18,32,148
Jalen Brunson,PG,26,NYK,24,24,775,181,375,.483,34,100,.340,147,275,.535,.528,109,125,.872,11,71,82,150,24,5,42,59,505
Thomas Bryant,C,25,LAL,8,1,102,26,36,.722,1,4,.250,25,32,.781,.736,11,20,.550,7,28,35,5,0,5,2,12,64
Reggie Bullock,SF,31,DAL,22,18,603,35,117,.299,27,97,.278,8,20,.400,.415,10,15,.667,10,57,67,21,19,2,8,51,107
Alec Burks,SG,31,DET,12,0,245,50,117,.427,20,54,.370,30,63,.476,.513,47,58,.810,4,27,31,20,12,1,13,31,167
Jimmy Butler,SF,33,MIA,15,15,533,103,208,.495,12,34,.353,91,174,.523,.524,97,112,.866,33,74,107,90,25,4,30,24,315
John Butler,C,20,POR,4,0,15,1,3,.333,0,2,.000,1,1,1.000,.333,0,0,,1,1,2,1,0,1,0,0,2
Jamal Cain,SF,23,MIA,8,0,93,15,28,.536,1,6,.167,14,22,.636,.554,4,6,.667,7,12,19,5,5,0,2,10,35
Kentavious Caldwell-Pope,SG,29,DEN,22,22,686,85,185,.459,46,100,.460,39,85,.459,.584,25,32,.781,12,52,64,46,26,9,28,41,241
Facundo Campazzo,PG,31,DAL,8,0,52,3,13,.231,3,11,.273,0,2,.000,.346,1,2,.500,0,2,2,9,6,0,3,3,10
Vlatko Čančar,PF,25,DEN,15,0,191,30,64,.469,14,34,.412,16,30,.533,.578,6,7,.857,4,21,25,14,7,4,8,22,80
Clint Capela,C,28,ATL,22,22,614,116,189,.614,0,0,,116,189,.614,.614,23,41,.561,98,171,269,16,14,31,22,53,255
Vernon Carey Jr.,C,21,WAS,3,0,5,0,2,.000,0,0,,0,2,.000,.000,0,0,,0,1,1,0,0,0,1,2,0
Jevon Carter,PG,27,MIL,23,21,622,74,172,.430,34,85,.400,40,87,.460,.529,16,19,.842,14,48,62,81,32,15,33,60,198
Wendell Carter Jr.,C,23,ORL,15,15,493,87,169,.515,18,52,.346,69,117,.590,.568,57,69,.826,32,104,136,49,8,8,39,48,249
Alex Caruso,PG,28,CHI,23,7,593,40,99,.404,20,56,.357,20,43,.465,.505,24,31,.774,9,54,63,85,33,18,32,53,124
Julian Champagnie,SF,21,PHI,2,0,7,0,2,.000,0,1,.000,0,1,.000,.000,0,0,,0,0,0,0,1,0,0,0,0
Justin Champagnie,SF,21,TOR,2,0,9,3,3,1.000,0,0,,3,3,1.000,1.000,0,0,,1,2,3,0,0,0,0,1,6
Kennedy Chandler,PG,20,MEM,9,0,105,12,38,.316,2,11,.182,10,27,.370,.342,3,7,.429,2,11,13,21,6,3,8,5,29
Max Christie,SG,19,LAL,10,0,112,9,23,.391,7,16,.438,2,7,.286,.543,3,4,.750,1,21,22,5,3,0,2,5,28
Josh Christopher,SG,21,HOU,17,0,122,21,48,.438,3,14,.214,18,34,.529,.469,5,6,.833,5,14,19,10,5,1,12,12,50
Brandon Clarke,PF,26,MEM,24,2,461,91,151,.603,1,6,.167,90,145,.621,.606,37,51,.725,29,86,115,29,8,21,29,54,220
Jordan Clarkson,SG,30,UTA,26,26,841,185,428,.432,70,200,.350,115,228,.504,.514,72,87,.828,32,70,102,124,9,9,69,54,512
Nic Claxton,C,23,BRK,24,24,672,127,174,.730,0,1,.000,127,173,.734,.730,28,65,.431,64,147,211,30,17,52,32,72,282
Amir Coffey,SG,25,LAC,21,6,313,25,66,.379,4,18,.222,21,48,.438,.409,30,37,.811,9,15,24,27,5,2,10,27,84
John Collins,PF,25,ATL,22,22,693,103,213,.484,16,73,.219,87,140,.621,.521,49,58,.845,26,138,164,28,20,31,30,71,271
Zach Collins,PF,25,SAS,14,3,265,45,95,.474,10,35,.286,35,60,.583,.526,11,15,.733,24,51,75,38,9,14,28,49,111
Mike Conley,PG,35,UTA,17,17,497,58,148,.392,32,83,.386,26,65,.400,.500,26,34,.765,7,34,41,134,20,5,25,35,174
Pat Connaughton,SG,30,MIL,7,0,125,16,53,.302,10,39,.256,6,14,.429,.396,5,6,.833,3,18,21,4,5,0,1,4,47
Robert Covington,PF,32,LAC,15,0,234,26,68,.382,15,44,.341,11,24,.458,.493,14,16,.875,5,53,58,18,6,10,12,30,81
Torrey Craig,SF,32,PHO,21,13,496,62,131,.473,26,68,.382,36,63,.571,.573,10,13,.769,40,64,104,30,13,16,14,50,160
Jarrett Culver,SG,23,ATL,5,1,90,11,23,.478,1,7,.143,10,16,.625,.500,6,9,.667,5,20,25,5,5,1,5,10,29
Cade Cunningham,PG,21,DET,12,12,400,93,224,.415,17,61,.279,76,163,.466,.453,36,43,.837,12,62,74,72,10,7,39,34,239
Seth Curry,SG,32,BRK,15,0,336,49,111,.441,26,63,.413,23,48,.479,.559,10,11,.909,4,30,34,34,9,4,20,29,134
Stephen Curry,PG,34,GSW,23,23,800,233,467,.499,117,271,.432,116,196,.592,.624,106,117,.906,12,140,152,162,24,6,72,49,689
Dyson Daniels,PG,19,NOP,15,2,281,31,62,.500,9,22,.409,22,40,.550,.573,9,14,.643,8,50,58,33,11,5,11,29,80
Anthony Davis,C,29,LAL,20,20,692,217,368,.590,9,27,.333,208,341,.610,.602,129,155,.832,68,188,256,52,27,48,40,57,572
Johnny Davis,SG,20,WAS,8,0,45,3,11,.273,0,2,.000,3,9,.333,.273,3,3,1.000,1,4,5,2,0,1,1,12,9
Terence Davis,SG,25,SAC,20,1,264,49,112,.438,28,71,.394,21,41,.512,.563,14,16,.875,9,51,60,30,16,4,15,36,140
JD Davison,PG,20,BOS,3,0,8,1,4,.250,0,2,.000,1,2,.500,.250,0,0,,0,1,1,1,1,0,1,0,2
Dewayne Dedmon,C,33,MIA,20,0,244,52,96,.542,9,26,.346,43,70,.614,.589,25,33,.758,19,53,72,12,4,8,13,39,138
Matthew Dellavedova,PG,32,SAC,9,0,59,5,17,.294,2,5,.400,3,12,.250,.353,1,3,.333,1,3,4,11,2,0,4,5,13
DeMar DeRozan,SF,33,CHI,23,23,801,208,414,.502,10,32,.313,198,382,.518,.514,160,181,.884,11,90,101,107,21,9,45,63,586
Moussa Diabaté,PF,21,LAC,5,0,53,7,11,.636,0,0,,7,11,.636,.636,7,8,.875,10,9,19,1,2,1,3,5,21
Mamadi Diakite,PF,26,CLE,10,2,81,10,21,.476,4,12,.333,6,9,.667,.571,0,0,,3,8,11,2,2,4,5,11,24
Hamidou Diallo,SG,24,DET,24,0,370,60,123,.488,2,13,.154,58,110,.527,.496,35,55,.636,23,45,68,23,13,5,21,51,157
Gorgui Dieng,C,33,SAS,11,1,117,16,37,.432,8,27,.296,8,10,.800,.541,3,4,.750,9,22,31,19,1,5,11,19,43
Ousmane Dieng,SF,19,OKC,14,0,220,25,59,.424,10,34,.294,15,25,.600,.508,1,4,.250,6,34,40,20,5,4,7,12,61
Spencer Dinwiddie,PG,29,DAL,23,23,726,136,296,.459,62,152,.408,74,144,.514,.564,45,55,.818,8,64,72,113,23,6,36,51,379
Donte DiVincenzo,SG,26,GSW,17,1,294,29,77,.377,17,54,.315,12,23,.522,.487,10,13,.769,11,41,52,35,17,2,22,33,85
Luka Dončić,PG,23,DAL,22,22,810,254,498,.510,61,178,.343,193,320,.603,.571,165,230,.717,19,168,187,188,40,15,79,64,734
Tyler Dorsey,SG,26,DAL,1,0,4,4,4,1.000,1,1,1.000,3,3,1.000,1.125,0,0,,1,1,2,0,0,0,0,0,9
Luguentz Dort,SG,23,OKC,24,24,734,119,294,.405,41,128,.320,78,166,.470,.474,61,79,.772,38,73,111,56,28,9,35,79,340
Ayo Dosunmu,PG,23,CHI,22,20,624,94,182,.516,22,66,.333,72,116,.621,.577,18,20,.900,12,63,75,64,14,9,34,56,228
Devon Dotson,PG,23,WAS,2,0,21,0,3,.000,0,1,.000,0,2,.000,.000,0,0,,3,1,4,2,1,0,0,3,0
Jeff Dowtin,PG,25,TOR,8,0,64,9,17,.529,1,4,.250,8,13,.615,.559,1,1,1.000,4,6,10,8,0,1,1,4,20
Goran Dragić,PG,36,CHI,22,0,383,68,156,.436,25,60,.417,43,96,.448,.516,17,26,.654,10,27,37,71,6,4,28,31,178
Andre Drummond,C,29,CHI,17,0,241,47,87,.540,0,2,.000,47,85,.553,.540,17,26,.654,45,86,131,14,9,7,20,34,111
Chris Duarte,SF,25,IND,9,5,177,28,71,.394,13,38,.342,15,33,.455,.486,11,12,.917,4,15,19,9,1,4,8,16,80
David Duke Jr.,SG,23,BRK,13,0,101,16,35,.457,0,4,.000,16,31,.516,.457,3,4,.750,4,8,12,9,4,1,9,19,35
Kevin Durant,PF,34,BRK,25,25,922,265,479,.553,39,115,.339,226,364,.621,.594,178,194,.918,9,157,166,135,18,44,86,62,747
Jalen Duren,C,19,DET,22,0,476,61,103,.592,0,1,.000,61,102,.598,.592,20,43,.465,63,84,147,14,13,20,21,53,142
Tari Eason,PF,21,HOU,24,0,448,81,188,.431,17,47,.362,64,141,.454,.476,32,38,.842,53,77,130,20,33,10,19,51,211
Anthony Edwards,SG,21,MIN,23,23,840,192,416,.462,59,171,.345,133,245,.543,.532,86,113,.761,13,116,129,88,38,9,73,64,529
Kessler Edwards,SF,22,BRK,12,0,39,3,13,.231,2,7,.286,1,6,.167,.308,1,2,.500,2,3,5,2,2,1,1,1,9
Keon Ellis,SG,23,SAC,1,0,2,0,0,,0,0,,0,0,,,0,0,,0,0,0,0,0,0,0,1,0
Joel Embiid,C,28,PHI,16,16,565,166,323,.514,15,54,.278,151,269,.561,.537,163,194,.840,26,127,153,79,18,28,66,53,510
Drew Eubanks,C,25,POR,22,3,384,49,69,.710,0,1,.000,49,68,.721,.710,23,34,.676,35,58,93,19,10,22,17,42,121
Bruno Fernando,C,24,HOU,8,3,109,20,29,.690,0,1,.000,20,28,.714,.690,6,10,.600,14,21,35,10,4,6,5,16,46
Dorian Finney-Smith,PF,29,DAL,23,23,753,70,174,.402,40,122,.328,30,52,.577,.517,14,19,.737,29,66,95,23,22,11,21,41,194
Malachi Flynn,PG,24,TOR,15,1,170,30,70,.429,17,36,.472,13,34,.382,.550,10,11,.909,2,16,18,18,6,1,9,24,87
Simone Fontecchio,SF,27,UTA,15,0,133,19,49,.388,14,35,.400,5,14,.357,.531,6,9,.667,7,11,18,6,2,3,8,13,58
Bryn Forbes,SG,29,MIN,12,0,124,15,45,.333,6,24,.250,9,21,.429,.400,7,7,1.000,3,3,6,9,7,0,5,9,43
Trent Forrest,PG,24,ATL,8,0,62,5,10,.500,0,0,,5,10,.500,.500,0,0,,2,5,7,9,2,0,2,4,10
Michael Foster Jr.,PF,20,PHI,1,0,1,0,0,,0,0,,0,0,,,0,0,,0,0,0,0,0,0,0,0,0
Evan Fournier,SG,30,NYK,13,7,260,31,90,.344,19,57,.333,12,33,.364,.450,9,11,.818,2,25,27,22,9,3,14,28,90
De'Aaron Fox,PG,25,SAC,21,21,665,180,349,.516,40,106,.377,140,243,.576,.573,86,105,.819,10,97,107,122,23,10,55,52,486
Markelle Fultz,SG,24,ORL,4,4,97,19,43,.442,2,6,.333,17,37,.459,.465,5,6,.833,5,8,13,16,5,1,8,6,45
Wenyen Gabriel,PF,25,LAL,20,2,271,40,67,.597,4,13,.308,36,54,.667,.627,18,22,.818,26,47,73,13,11,10,14,35,102
Daniel Gafford,C,24,WAS,24,0,320,57,79,.722,0,0,,57,79,.722,.722,27,47,.574,41,60,101,10,8,27,21,42,141
Darius Garland,PG,23,CLE,18,18,646,135,311,.434,51,125,.408,84,186,.452,.516,79,92,.859,5,34,39,139,22,4,59,36,400
Usman Garuba,PF,20,HOU,22,1,339,32,56,.571,7,11,.636,25,45,.556,.634,14,24,.583,39,69,108,23,19,16,19,42,85
Luka Garza,C,24,MIN,1,0,1,0,0,,0,0,,0,0,,,0,0,,0,0,0,0,0,0,0,0,0
Rudy Gay,SF,36,UTA,12,0,189,21,58,.362,9,34,.265,12,24,.500,.440,3,6,.500,6,35,41,10,5,6,10,16,54
Paul George,SF,32,LAC,17,17,577,140,303,.462,47,125,.376,93,178,.522,.540,70,82,.854,9,90,99,76,25,7,60,44,397
Taj Gibson,PF,37,WAS,12,0,77,12,25,.480,1,6,.167,11,19,.579,.500,8,8,1.000,6,12,18,4,4,2,3,14,33
Josh Giddey,SG,20,OKC,21,21,640,133,293,.454,19,66,.288,114,227,.502,.486,26,36,.722,34,125,159,115,13,11,68,48,311
Shai Gilgeous-Alexander,SG,24,OKC,22,22,786,235,464,.506,22,67,.328,213,397,.537,.530,197,212,.929,21,84,105,132,39,25,73,54,689
Anthony Gill,PF,30,WAS,20,4,240,26,48,.542,2,13,.154,24,35,.686,.563,11,13,.846,14,20,34,11,4,5,4,30,65
Rudy Gobert,C,30,MIN,21,21,640,103,158,.652,0,2,.000,103,156,.660,.652,71,99,.717,77,163,240,17,14,27,32,64,277
Jordan Goodwin,PG,24,WAS,17,1,351,45,91,.495,13,27,.481,32,64,.500,.566,11,17,.647,21,47,68,47,14,13,16,33,114
Aaron Gordon,PF,27,DEN,20,20,584,124,204,.608,21,56,.375,103,148,.696,.659,53,84,.631,47,86,133,46,13,17,28,36,322
Eric Gordon,SG,34,HOU,20,20,601,82,188,.436,38,108,.352,44,80,.550,.537,44,51,.863,6,33,39,51,14,7,38,15,246
Devonte' Graham,PG,27,NOP,23,0,370,40,107,.374,36,91,.396,4,16,.250,.542,18,23,.783,5,29,34,51,12,6,14,19,134
Jerami Grant,PF,28,POR,23,23,835,172,362,.475,65,141,.461,107,221,.484,.565,119,153,.778,20,75,95,64,19,20,44,52,528
A.J. Green,SG,23,MIL,8,0,47,7,14,.500,6,12,.500,1,2,.500,.714,3,3,1.000,1,6,7,2,1,0,1,7,23
Draymond Green,PF,32,GSW,23,23,714,80,143,.559,11,35,.314,69,108,.639,.598,26,36,.722,16,129,145,162,21,19,55,74,197
Jalen Green,SG,20,HOU,24,24,832,176,424,.415,57,179,.318,119,245,.486,.482,109,137,.796,15,80,95,95,20,5,80,42,518
JaMychal Green,PF,32,GSW,22,0,332,51,101,.505,6,34,.176,45,67,.672,.535,14,18,.778,31,54,85,15,13,8,22,45,122
Javonte Green,SG,29,CHI,22,1,361,51,87,.586,10,27,.370,41,60,.683,.644,20,31,.645,22,46,68,18,21,15,13,36,132
Jeff Green,PF,36,DEN,16,3,319,47,89,.528,5,20,.250,42,69,.609,.556,28,36,.778,12,29,41,19,6,3,16,33,127
Josh Green,SG,22,DAL,23,1,464,56,93,.602,24,52,.462,32,41,.780,.731,30,43,.698,20,33,53,28,23,1,16,56,166
AJ Griffin,SF,19,ATL,20,3,386,77,163,.472,32,85,.376,45,78,.577,.571,7,7,1.000,16,26,42,16,23,1,15,22,193
Blake Griffin,PF,33,BOS,9,4,132,17,30,.567,4,11,.364,13,19,.684,.633,8,11,.727,11,21,32,8,3,0,6,20,46
Quentin Grimes,SG,22,NYK,14,9,295,32,72,.444,11,41,.268,21,31,.677,.521,4,5,.800,10,29,39,24,9,4,13,34,79
Rui Hachimura,PF,24,WAS,16,0,376,76,158,.481,12,36,.333,64,122,.525,.519,21,29,.724,12,65,77,17,5,8,22,18,185
Tyrese Haliburton,PG,22,IND,22,22,731,155,336,.461,58,157,.369,97,179,.542,.548,52,62,.839,17,86,103,239,40,6,58,24,420
Jordan Hall,SF,21,SAS,9,0,83,9,28,.321,3,15,.200,6,13,.462,.375,7,9,.778,3,9,12,11,1,0,7,6,28
R.J. Hampton,PG,21,ORL,21,0,327,46,105,.438,17,49,.347,29,56,.518,.519,27,31,.871,9,25,34,32,16,4,19,20,136
Tim Hardaway Jr.,SG,30,DAL,22,5,549,90,248,.363,59,166,.355,31,82,.378,.482,38,45,.844,6,50,56,43,17,4,20,28,277
James Harden,SG,33,PHI,10,10,369,67,162,.414,24,71,.338,43,91,.473,.488,61,66,.924,6,61,67,97,12,6,33,20,219
Jaden Hardy,SG,20,DAL,5,0,19,6,15,.400,1,5,.200,5,10,.500,.433,2,2,1.000,0,3,3,1,0,0,2,5,15
Ron Harper Jr.,SF,22,TOR,2,0,8,2,4,.500,2,3,.667,0,1,.000,.750,0,0,,0,1,1,0,0,0,0,0,6
Montrezl Harrell,C,29,PHI,20,5,240,34,64,.531,0,0,,34,64,.531,.531,35,47,.745,21,38,59,10,4,8,13,22,103
Gary Harris,SG,28,ORL,6,3,155,23,48,.479,10,23,.435,13,25,.520,.583,6,6,1.000,5,11,16,12,4,2,9,13,62
Joe Harris,SG,31,BRK,23,14,600,70,176,.398,46,125,.368,24,51,.471,.528,11,15,.733,11,63,74,39,13,6,14,58,197
Kevon Harris,SG,25,ORL,17,0,214,22,55,.400,6,17,.353,16,38,.421,.455,20,24,.833,18,22,40,9,7,1,14,23,70
Tobias Harris,PF,30,PHI,22,22,751,143,299,.478,49,118,.415,94,181,.519,.560,37,44,.841,19,120,139,59,29,10,29,47,372
Josh Hart,SG,27,POR,22,22,782,78,161,.484,14,43,.326,64,118,.542,.528,41,56,.732,42,144,186,93,32,3,38,61,211
Isaiah Hartenstein,C,24,NYK,24,7,501,64,120,.533,4,18,.222,60,102,.588,.550,21,25,.840,71,94,165,18,19,23,22,62,153
Udonis Haslem,PF,42,MIA,4,0,24,1,6,.167,0,1,.000,1,5,.200,.167,1,2,.500,2,2,4,0,1,1,0,4,3
Sam Hauser,PF,25,BOS,25,0,417,61,121,.504,49,106,.462,12,15,.800,.707,7,9,.778,9,52,61,19,6,7,7,36,178
Jaxson Hayes,C,22,NOP,9,0,67,3,16,.188,0,8,.000,3,8,.375,.188,4,7,.571,3,13,16,5,3,1,3,6,10
Killian Hayes,PG,21,DET,25,12,606,81,217,.373,24,71,.338,57,146,.390,.429,16,19,.842,11,55,66,117,27,12,43,75,202
Gordon Hayward,SF,32,CHO,11,11,355,65,146,.445,16,42,.381,49,104,.471,.500,33,43,.767,7,40,47,48,7,3,28,10,179
Juancho Hernangómez,PF,27,TOR,16,3,271,29,56,.518,10,29,.345,19,27,.704,.607,3,7,.429,13,52,65,13,10,3,10,20,71
Willy Hernangómez,C,28,NOP,10,0,99,17,35,.486,0,3,.000,17,32,.531,.486,18,22,.818,15,25,40,5,3,2,11,10,52
Tyler Herro,SG,23,MIA,16,16,538,112,256,.438,42,119,.353,70,137,.511,.520,40,45,.889,11,98,109,66,12,8,42,27,306
Buddy Hield,SG,30,IND,24,24,759,142,343,.414,83,227,.366,59,116,.509,.535,38,45,.844,25,92,117,64,24,9,51,51,405
Haywood Highsmith,SF,26,MIA,15,1,282,23,68,.338,11,36,.306,12,32,.375,.419,4,10,.400,15,49,64,9,12,6,11,11,61
George Hill,PG,36,MIL,23,0,468,38,91,.418,13,45,.289,25,46,.543,.489,26,38,.684,8,35,43,57,10,3,18,30,115
Malcolm Hill,SF,27,CHI,3,0,1,0,0,,0,0,,0,0,,,0,0,,0,1,1,0,0,0,0,0,0
Aaron Holiday,PG,26,ATL,21,1,359,36,85,.424,14,30,.467,22,55,.400,.506,10,13,.769,9,21,30,29,13,3,17,36,96
Jrue Holiday,PG,32,MIL,18,17,584,125,280,.446,38,113,.336,87,167,.521,.514,41,46,.891,22,71,93,135,29,9,59,37,329
Justin Holiday,SG,33,ATL,18,0,303,39,97,.402,24,68,.353,15,29,.517,.526,0,0,,1,16,17,17,4,5,10,30,102
Richaun Holmes,PF,29,SAC,12,0,127,16,24,.667,1,2,.500,15,22,.682,.688,4,6,.667,8,17,25,0,2,1,5,19,37
Al Horford,C,36,BOS,20,20,632,79,147,.537,41,88,.466,38,59,.644,.677,5,8,.625,20,105,125,55,9,20,15,40,204
Talen Horton-Tucker,SG,22,UTA,25,0,421,67,172,.390,18,71,.254,49,101,.485,.442,28,38,.737,11,55,66,62,21,9,34,38,180
Danuel House Jr.,SF,29,PHI,22,2,405,36,75,.480,15,43,.349,21,32,.656,.580,21,28,.750,4,40,44,17,6,5,13,30,108
Caleb Houstan,SF,20,ORL,20,1,379,28,78,.359,20,56,.357,8,22,.364,.487,8,10,.800,14,39,53,16,4,2,5,35,84
Trevor Hudgins,PG,23,HOU,1,0,4,1,1,1.000,1,1,1.000,0,0,,1.500,0,0,,0,0,0,0,0,0,0,0,3
Kevin Huerter,SG,24,SAC,22,22,700,120,253,.474,66,156,.423,54,97,.557,.605,36,52,.692,9,62,71,71,23,9,33,52,342
De'Andre Hunter,SF,25,ATL,21,21,648,113,253,.447,28,79,.354,85,174,.489,.502,59,73,.808,14,70,84,23,7,3,28,63,313
Bones Hyland,PG,22,DEN,15,0,307,69,173,.399,40,92,.435,29,81,.358,.514,33,41,.805,4,25,29,50,9,4,27,24,211
Serge Ibaka,PF,33,MIL,14,0,159,23,44,.523,6,14,.429,17,30,.567,.591,8,13,.615,12,28,40,4,0,6,8,20,60
Brandon Ingram,SF,25,NOP,15,15,481,109,231,.472,28,60,.467,81,171,.474,.532,66,76,.868,7,69,76,70,13,10,42,33,312
Kyrie Irving,PG,30,BRK,17,17,627,155,328,.473,44,136,.324,111,192,.578,.540,61,68,.897,11,63,74,74,16,16,39,50,415
Jaden Ivey,SG,20,DET,21,20,667,117,283,.413,31,100,.310,86,183,.470,.468,69,94,.734,24,78,102,90,25,6,57,60,334
Isaiah Jackson,PF,21,IND,23,3,379,63,114,.553,1,4,.250,62,110,.564,.557,45,64,.703,35,66,101,24,11,29,23,56,172
Jaren Jackson Jr.,C,23,MEM,8,8,210,51,105,.486,14,42,.333,37,63,.587,.552,39,49,.796,19,34,53,1,7,23,14,25,155
Justin Jackson,SF,27,BOS,9,0,46,2,10,.200,2,9,.222,0,1,.000,.300,0,0,,0,5,5,2,2,1,0,3,6
Reggie Jackson,PG,32,LAC,25,25,732,115,273,.421,39,112,.348,76,161,.472,.493,38,43,.884,10,55,65,108,16,3,58,47,307
LeBron James,PF,38,LAL,16,16,566,163,350,.466,39,118,.331,124,232,.534,.521,53,74,.716,23,114,137,105,19,10,55,32,418
Ty Jerome,SG,25,GSW,10,0,149,19,35,.543,7,17,.412,12,18,.667,.643,12,12,1.000,1,8,9,19,1,1,4,12,57
Isaiah Joe,SG,23,OKC,17,0,140,29,59,.492,23,50,.460,6,9,.667,.686,7,9,.778,2,20,22,16,7,1,6,15,88
Alize Johnson,PF,26,SAS,3,0,24,3,6,.500,0,2,.000,3,4,.750,.500,1,2,.500,2,7,9,0,1,0,3,1,7
Cameron Johnson,PF,26,PHO,8,8,202,37,83,.446,22,51,.431,15,32,.469,.578,8,11,.727,5,22,27,14,9,3,2,14,104
Jalen Johnson,SF,21,ATL,22,2,328,44,93,.473,6,30,.200,38,63,.603,.505,10,15,.667,13,63,76,21,14,7,10,34,104
James Johnson,PF,35,IND,7,0,62,6,16,.375,1,7,.143,5,9,.556,.406,0,0,,0,8,8,5,1,2,2,16,13
Keldon Johnson,SF,23,SAS,22,22,711,157,400,.393,64,185,.346,93,215,.433,.473,70,96,.729,21,91,112,68,20,2,50,43,448
Keon Johnson,SG,20,POR,6,0,106,16,45,.356,8,23,.348,8,22,.364,.444,2,6,.333,3,12,15,10,5,2,13,10,42
Nikola Jokić,C,27,DEN,20,20,643,174,274,.635,16,47,.340,158,227,.696,.664,100,124,.806,39,163,202,178,26,12,65,59,464
Damian Jones,C,27,LAL,11,1,82,10,21,.476,0,1,.000,10,20,.500,.476,7,10,.700,9,17,26,3,1,5,5,10,27
Derrick Jones Jr.,SF,25,CHI,18,0,230,27,61,.443,4,18,.222,23,43,.535,.475,28,33,.848,17,24,41,8,7,12,8,23,86
Herbert Jones,SF,24,NOP,17,17,479,63,142,.444,14,49,.286,49,93,.527,.493,40,54,.741,21,42,63,35,20,14,21,56,180
Kai Jones,C,22,CHO,15,0,140,17,37,.459,2,9,.222,15,28,.536,.486,5,8,.625,13,19,32,4,3,8,5,15,41
Tre Jones,PG,23,SAS,23,23,695,104,250,.416,18,59,.305,86,191,.450,.452,52,57,.912,17,61,78,158,35,4,47,43,278
Tyus Jones,PG,26,MEM,24,4,573,98,218,.450,35,93,.376,63,125,.504,.530,19,27,.704,9,42,51,108,15,2,25,12,250
DeAndre Jordan,C,34,DEN,19,3,298,43,57,.754,1,1,1.000,42,56,.750,.763,14,30,.467,31,81,112,19,3,12,25,31,101
Cory Joseph,PG,31,DET,19,2,274,36,81,.444,13,32,.406,23,49,.469,.525,9,14,.643,5,13,18,54,5,1,9,29,94
Nikola Jović,PF,19,MIA,10,6,160,21,53,.396,5,25,.200,16,28,.571,.443,18,19,.947,7,19,26,10,6,1,8,12,65
Mfiondu Kabengele,PF,25,BOS,1,0,8,1,2,.500,0,1,.000,1,1,1.000,.500,0,0,,3,1,4,0,0,0,0,1,2
Frank Kaminsky,C,29,ATL,10,0,61,7,12,.583,3,6,.500,4,6,.667,.708,4,4,1.000,0,12,12,6,0,0,3,10,21
Trevor Keels,SG,19,NYK,1,0,1,0,1,.000,0,1,.000,0,0,,.000,0,0,,0,1,1,0,0,0,0,0,0
Luke Kennard,SG,26,LAC,15,7,318,44,85,.518,25,51,.490,19,34,.559,.665,4,4,1.000,4,39,43,10,8,0,15,20,117
Walker Kessler,C,21,UTA,23,0,364,56,74,.757,0,0,,56,74,.757,.757,21,37,.568,47,74,121,14,4,39,15,46,133
Braxton Key,SF,25,DET,3,0,9,1,1,1.000,0,0,,1,1,1.000,1.000,2,2,1.000,0,1,1,0,0,0,0,0,4
Corey Kispert,SF,23,WAS,16,9,426,56,103,.544,30,65,.462,26,38,.684,.689,14,19,.737,8,29,37,28,10,3,10,24,156
Maxi Kleber,C,31,DAL,19,0,478,41,87,.471,19,54,.352,22,33,.667,.580,11,14,.786,16,50,66,20,6,17,12,40,112
Nathan Knight,PF,25,MIN,9,0,24,1,3,.333,0,1,.000,1,2,.500,.333,3,5,.600,0,6,6,0,3,0,2,2,5
Kevin Knox,SF,23,DET,18,0,239,33,74,.446,16,47,.340,17,27,.630,.554,7,11,.636,9,34,43,7,6,7,8,26,89
Christian Koloko,C,22,TOR,24,12,409,36,78,.462,0,6,.000,36,72,.500,.462,27,41,.659,42,46,88,11,5,29,14,66,99
John Konchar,SG,26,MEM,22,14,614,68,145,.469,37,90,.411,31,55,.564,.597,14,16,.875,30,112,142,31,24,7,17,39,187
Furkan Korkmaz,SG,25,PHI,13,0,168,22,52,.423,10,27,.370,12,25,.480,.519,13,18,.722,4,12,16,13,3,2,10,7,67
Luke Kornet,C,27,BOS,20,0,261,38,56,.679,2,6,.333,36,50,.720,.696,15,16,.938,25,47,72,15,3,19,11,33,93
Vit Krejci,PG,22,ATL,11,0,65,5,15,.333,3,12,.250,2,3,.667,.433,0,0,,1,4,5,8,0,1,1,6,13
Jonathan Kuminga,PF,20,GSW,21,2,334,44,101,.436,9,38,.237,35,63,.556,.480,21,28,.750,18,43,61,19,7,10,27,42,118
Kyle Kuzma,PF,27,WAS,23,23,793,180,392,.459,51,167,.305,129,225,.573,.524,62,84,.738,23,153,176,82,9,11,58,63,473
Anthony Lamb,SF,25,GSW,17,2,312,39,75,.520,18,46,.391,21,29,.724,.640,2,4,.500,12,46,58,28,10,4,18,41,98
Jock Landale,C,27,PHO,21,0,268,50,96,.521,4,28,.143,46,68,.676,.542,28,35,.800,33,43,76,14,6,14,15,41,132
Romeo Langford,SG,23,SAS,13,2,235,29,64,.453,3,17,.176,26,47,.553,.477,11,17,.647,22,13,35,9,7,4,10,23,72
Jake LaRavia,PF,21,MEM,16,0,295,29,70,.414,19,49,.388,10,21,.476,.550,5,5,1.000,13,37,50,16,9,3,15,33,82
Zach LaVine,SG,27,CHI,19,19,652,147,348,.422,54,154,.351,93,194,.479,.500,70,85,.824,15,72,87,80,24,1,41,47,418
A.J. Lawson,SG,22,MIN,1,0,2,1,1,1.000,0,0,,1,1,1.000,1.000,0,0,,0,1,1,0,0,0,0,1,2
Damion Lee,SG,30,PHO,24,0,511,68,147,.463,45,93,.484,23,54,.426,.616,21,23,.913,20,67,87,33,12,1,19,37,202
Saben Lee,PG,23,PHI,2,0,10,3,4,.750,0,1,.000,3,3,1.000,.750,0,0,,0,0,0,2,1,0,3,1,6
Alex Len,C,29,SAC,7,0,23,5,8,.625,0,0,,5,8,.625,.625,1,2,.500,3,5,8,1,0,0,0,3,11
Kawhi Leonard,SF,31,LAC,6,4,140,26,60,.433,2,18,.111,24,42,.571,.450,12,15,.800,5,21,26,19,3,1,6,10,66
Caris LeVert,SG,28,CLE,20,14,619,76,204,.373,30,82,.366,46,122,.377,.446,42,53,.792,19,70,89,90,15,2,37,45,224
Damian Lillard,PG,32,POR,12,12,419,91,215,.423,42,121,.347,49,94,.521,.521,86,98,.878,10,41,51,83,7,4,46,22,310
Nassir Little,PF,22,POR,21,0,321,43,91,.473,16,43,.372,27,48,.563,.560,14,21,.667,7,43,50,18,8,3,14,17,116
Isaiah Livers,PF,24,DET,22,7,430,42,104,.404,29,81,.358,13,23,.565,.543,15,20,.750,11,39,50,13,9,12,13,42,128
Kenneth Lofton Jr.,PF,20,MEM,4,0,19,5,12,.417,0,1,.000,5,11,.455,.417,1,3,.333,1,2,3,3,0,0,1,3,11
Kevon Looney,C,26,GSW,25,25,567,68,102,.667,0,0,,68,102,.667,.667,23,38,.605,56,125,181,71,10,13,10,69,159
Brook Lopez,C,34,MIL,22,22,685,123,247,.498,53,127,.417,70,120,.583,.605,37,45,.822,35,94,129,25,13,66,29,49,336
Robin Lopez,C,34,CLE,18,1,173,26,40,.650,0,0,,26,40,.650,.650,9,12,.750,17,9,26,8,1,2,12,23,61
Kevin Love,PF,34,CLE,18,1,376,58,138,.420,39,99,.394,19,39,.487,.562,33,38,.868,13,120,133,43,3,3,23,25,188
Kyle Lowry,PG,36,MIA,24,24,874,106,264,.402,57,162,.352,49,102,.480,.509,82,96,.854,20,98,118,145,25,15,62,70,351
Trey Lyles,PF,27,SAC,17,0,242,35,86,.407,21,61,.344,14,25,.560,.529,16,22,.727,17,31,48,13,6,7,17,20,107
Théo Maledon,PG,21,CHO,22,1,368,43,96,.448,14,36,.389,29,60,.483,.521,20,23,.870,5,47,52,55,18,5,26,22,120
Sandro Mamukelashvili,C,23,MIL,11,0,88,11,28,.393,4,15,.267,7,13,.538,.464,5,10,.500,5,18,23,3,1,2,4,8,31
Terance Mann,SG,26,LAC,25,12,531,81,149,.544,15,46,.326,66,103,.641,.594,27,37,.730,24,60,84,45,14,6,26,49,204
Tre Mann,PG,21,OKC,21,4,464,76,200,.380,30,107,.280,46,93,.495,.455,11,17,.647,11,46,57,38,19,3,22,37,193
Boban Marjanović,C,34,HOU,7,0,25,3,7,.429,0,1,.000,3,6,.500,.429,4,6,.667,1,6,7,1,1,1,2,1,10
Lauri Markkanen,SF,25,UTA,26,26,881,207,392,.528,69,167,.413,138,225,.613,.616,95,114,.833,57,165,222,58,15,18,56,53,578
Naji Marshall,SF,25,NOP,21,4,427,52,125,.416,17,52,.327,35,73,.479,.484,23,29,.793,16,46,62,45,15,4,18,26,144
Caleb Martin,PF,27,MIA,23,23,741,103,211,.488,34,82,.415,69,129,.535,.569,23,30,.767,39,71,110,45,27,9,26,42,263
Cody Martin,SF,27,CHO,1,0,1,0,0,,0,0,,0,0,,,0,0,,0,0,0,0,0,0,0,0,0
Kenyon Martin Jr.,SF,22,HOU,24,6,587,101,186,.543,22,68,.324,79,118,.669,.602,40,58,.690,36,87,123,33,9,10,28,42,264
Tyrese Martin,SG,23,ATL,7,0,21,3,6,.500,1,3,.333,2,3,.667,.583,0,0,,2,2,4,0,1,0,0,1,7
Garrison Mathews,SG,26,HOU,21,0,286,28,75,.373,27,72,.375,1,3,.333,.553,24,26,.923,3,21,24,9,12,1,7,31,107
Bennedict Mathurin,SG,20,IND,24,1,685,137,329,.416,48,128,.375,89,201,.443,.489,117,146,.801,29,63,92,37,15,2,44,47,439
Wesley Matthews,SG,36,MIL,18,0,279,18,59,.305,14,47,.298,4,12,.333,.424,7,8,.875,15,19,34,10,9,4,6,30,57
Tyrese Maxey,SG,22,PHI,15,15,546,126,273,.462,43,102,.422,83,171,.485,.540,48,65,.738,6,46,52,66,15,4,30,35,343
Miles McBride,PG,22,NYK,12,0,82,9,28,.321,1,15,.067,8,13,.615,.339,2,6,.333,0,3,3,15,5,0,3,9,21
CJ McCollum,SG,31,NOP,19,19,663,130,327,.398,42,127,.331,88,200,.440,.462,28,35,.800,18,75,93,114,21,10,38,33,330
T.J. McConnell,PG,30,IND,21,0,377,53,114,.465,4,12,.333,49,102,.480,.482,11,12,.917,14,39,53,90,26,5,37,26,121
Jaden McDaniels,PF,22,MIN,20,20,586,88,163,.540,22,59,.373,66,104,.635,.607,26,34,.765,28,40,68,26,22,27,31,75,224
Jalen McDaniels,SF,25,CHO,24,6,635,89,203,.438,30,85,.353,59,118,.500,.512,35,41,.854,23,88,111,55,24,13,32,70,243
Doug McDermott,SF,31,SAS,20,0,414,78,165,.473,39,96,.406,39,69,.565,.591,10,16,.625,5,32,37,29,2,3,20,33,205
JaVale McGee,C,35,DAL,16,7,141,27,46,.587,0,0,,27,46,.587,.587,11,20,.550,11,29,40,4,3,9,16,18,65
Bryce McGowens,SG,20,CHO,9,0,109,13,28,.464,4,9,.444,9,19,.474,.536,8,9,.889,2,9,11,8,3,4,3,4,38
Rodney McGruder,SG,31,DET,8,2,68,5,19,.263,3,14,.214,2,5,.400,.342,2,2,1.000,6,8,14,7,0,0,3,2,15
Jordan McLaughlin,PG,26,MIN,16,0,261,25,60,.417,8,32,.250,17,28,.607,.483,9,9,1.000,6,23,29,60,14,2,11,6,67
De'Anthony Melton,PG,24,PHI,22,15,635,91,225,.404,44,123,.358,47,102,.461,.502,14,21,.667,26,72,98,74,45,10,40,48,240
Chimezie Metu,C,25,SAC,18,0,227,45,72,.625,3,16,.188,42,56,.750,.646,14,16,.875,13,50,63,14,6,5,12,22,107
Khris Middleton,SF,31,MIL,2,2,52,7,22,.318,3,11,.273,4,11,.364,.386,5,6,.833,0,3,3,12,1,0,2,6,22
Patty Mills,PG,34,BRK,20,0,219,30,71,.423,21,55,.382,9,16,.563,.570,10,10,1.000,5,11,16,21,4,1,7,10,91
Shake Milton,SG,26,PHI,20,8,486,92,176,.523,18,46,.391,74,130,.569,.574,33,38,.868,16,52,68,72,7,4,38,31,235
Josh Minott,SF,20,MIN,1,0,5,1,1,1.000,0,0,,1,1,1.000,1.000,2,2,1.000,2,1,3,1,0,1,0,1,4
Davion Mitchell,PG,24,SAC,22,1,423,59,132,.447,18,59,.305,41,73,.562,.515,11,15,.733,2,29,31,51,12,5,23,36,147
Donovan Mitchell,SG,26,CLE,22,22,803,216,443,.488,85,202,.421,131,241,.544,.584,108,122,.885,18,67,85,107,30,10,68,54,625
Evan Mobley,PF,21,CLE,24,24,820,149,264,.564,5,22,.227,144,242,.595,.574,57,84,.679,68,153,221,58,21,36,51,65,360
Isaiah Mobley,PF,23,CLE,7,0,25,4,8,.500,1,2,.500,3,6,.500,.563,0,0,,1,10,11,0,1,0,0,2,9
Chima Moneke,SF,27,SAC,2,0,8,1,2,.500,0,0,,1,2,.500,.500,0,2,.000,2,0,2,1,0,0,2,2,2
Malik Monk,SG,24,SAC,22,0,490,118,242,.488,46,125,.368,72,117,.615,.583,42,47,.894,8,38,46,94,16,4,41,40,324
Moses Moody,SG,20,GSW,20,1,292,32,77,.416,18,50,.360,14,27,.519,.532,18,22,.818,5,31,36,12,7,5,20,14,100
Wendell Moore Jr.,SG,21,MIN,6,2,48,7,16,.438,2,8,.250,5,8,.625,.500,2,3,.667,1,5,6,3,1,1,4,6,18
Ja Morant,PG,23,MEM,20,20,665,198,427,.464,37,100,.370,161,327,.492,.507,136,183,.743,26,100,126,149,21,5,76,38,569
Marcus Morris,PF,33,LAC,23,23,690,122,274,.445,46,126,.365,76,148,.514,.529,23,31,.742,11,101,112,45,18,8,21,53,313
Markieff Morris,PF,33,BRK,14,0,145,16,41,.390,13,28,.464,3,13,.231,.549,0,0,,5,22,27,14,5,2,8,17,45
Monte Morris,PG,27,WAS,21,21,571,75,168,.446,25,66,.379,50,102,.490,.521,17,23,.739,9,68,77,106,16,4,18,27,192
Trey Murphy III,SF,22,NOP,21,11,596,94,195,.482,51,124,.411,43,71,.606,.613,38,40,.950,24,67,91,27,25,10,17,39,277
Dejounte Murray,SG,26,ATL,24,24,886,205,454,.452,53,145,.366,152,309,.492,.510,54,65,.831,19,117,136,156,44,11,64,42,517
Jamal Murray,PG,25,DEN,19,19,567,130,294,.442,38,100,.380,92,194,.474,.507,43,55,.782,10,61,71,94,18,5,38,24,341
Keegan Murray,SF,22,SAC,20,18,567,82,198,.414,38,114,.333,44,84,.524,.510,23,27,.852,18,64,82,18,15,12,31,41,225
Mike Muscala,C,31,OKC,15,1,193,31,70,.443,15,46,.326,16,24,.667,.550,12,16,.750,7,44,51,14,2,8,7,24,89
Svi Mykhailiuk,SF,25,NYK,7,0,23,4,7,.571,4,5,.800,0,2,.000,.857,1,3,.333,0,5,5,0,0,0,1,0,13
Larry Nance Jr.,PF,30,NOP,21,0,466,82,124,.661,7,17,.412,75,107,.701,.690,19,25,.760,33,77,110,36,17,17,21,45,190
Andrew Nembhard,SG,23,IND,19,10,452,66,136,.485,30,70,.429,36,66,.545,.596,10,11,.909,9,45,54,79,17,3,25,50,172
Aaron Nesmith,SF,23,IND,20,11,429,51,137,.372,27,79,.342,24,58,.414,.471,23,28,.821,10,54,64,25,16,10,19,60,152
Raul Neto,PG,30,CLE,15,0,134,17,36,.472,4,13,.308,13,23,.565,.528,7,8,.875,2,11,13,17,6,0,6,9,45
Georges Niang,PF,29,PHI,23,0,453,78,169,.462,53,123,.431,25,46,.543,.618,13,15,.867,5,43,48,26,10,7,18,49,222
Daishen Nix,PG,20,HOU,22,0,331,24,70,.343,16,46,.348,8,24,.333,.457,9,13,.692,8,29,37,54,15,3,31,20,73
Zeke Nnaji,PF,22,DEN,17,0,167,32,55,.582,3,14,.214,29,41,.707,.609,8,10,.800,16,8,24,3,3,2,8,25,75
Nerlens Noel,C,28,DET,6,0,62,4,13,.308,0,0,,4,13,.308,.308,3,4,.750,3,16,19,3,5,2,3,9,11
Jaylen Nowell,SG,23,MIN,23,0,417,101,234,.432,31,97,.320,70,137,.511,.498,31,39,.795,16,48,64,46,14,2,22,35,264
Frank Ntilikina,PG,24,DAL,7,0,39,4,11,.364,1,5,.200,3,6,.500,.409,0,0,,0,6,6,4,3,0,2,4,9
Kendrick Nunn,PG,27,LAL,19,2,253,40,112,.357,16,57,.281,24,55,.436,.429,8,9,.889,1,25,26,24,2,1,24,16,104
Jusuf Nurkić,C,28,POR,21,21,623,115,225,.511,15,35,.429,100,190,.526,.544,59,84,.702,59,151,210,59,15,18,51,69,304
Jordan Nwora,SF,24,MIL,21,3,400,49,134,.366,26,69,.377,23,65,.354,.463,24,29,.828,19,56,75,23,7,3,20,21,148
Royce O'Neale,SF,29,BRK,25,25,897,84,220,.382,58,142,.408,26,78,.333,.514,16,23,.696,20,112,132,117,29,17,44,83,242
Chuma Okeke,PF,24,ORL,18,7,392,32,87,.368,18,60,.300,14,27,.519,.471,16,21,.762,21,55,76,26,11,9,9,34,98
Josh Okogie,SG,24,PHO,20,0,166,17,51,.333,3,23,.130,14,28,.500,.363,10,16,.625,15,25,40,15,12,6,10,21,47
Onyeka Okongwu,C,22,ATL,23,2,468,75,116,.647,0,2,.000,75,114,.658,.647,27,37,.730,49,90,139,24,12,17,21,69,177
Isaac Okoro,SG,22,CLE,24,4,461,35,88,.398,8,40,.200,27,48,.563,.443,23,28,.821,13,37,50,15,15,4,17,53,101
KZ Okpala,PF,23,SAC,14,3,130,11,23,.478,3,9,.333,8,14,.571,.543,6,6,1.000,5,16,21,8,3,3,3,17,31
Kelly Olynyk,PF,31,UTA,26,26,741,117,209,.560,41,88,.466,76,121,.628,.658,64,80,.800,34,96,130,83,33,19,58,107,339
Eugene Omoruyi,SF,25,OKC,8,0,95,17,33,.515,6,13,.462,11,20,.550,.606,7,11,.636,6,8,14,2,3,0,5,21,47
Cedi Osman,SF,27,CLE,24,0,557,79,174,.454,34,98,.347,45,76,.592,.552,25,35,.714,7,66,73,41,9,3,24,46,217
Kelly Oubre Jr.,SF,27,CHO,24,24,776,180,418,.431,55,175,.314,125,243,.514,.496,68,93,.731,38,88,126,30,40,6,27,73,483
Chris Paul,PG,37,PHO,10,10,302,28,76,.368,9,33,.273,19,43,.442,.428,30,34,.882,5,40,45,94,17,2,15,23,95
Cameron Payne,PG,28,PHO,22,14,580,107,259,.413,42,108,.389,65,151,.430,.494,31,41,.756,8,50,58,127,22,5,47,50,287
Theo Pinson,SG,27,DAL,7,0,24,1,4,.250,0,3,.000,1,1,1.000,.250,2,2,1.000,0,6,6,2,1,0,1,1,4
Scotty Pippen Jr.,PG,22,LAL,2,0,8,0,2,.000,0,0,,0,2,.000,.000,3,4,.750,1,1,2,0,0,0,1,2,3
Mason Plumlee,C,32,CHO,24,24,663,85,145,.586,0,0,,85,145,.586,.586,54,94,.574,72,147,219,98,14,13,45,81,224
Jakob Poeltl,C,27,SAS,20,20,545,114,178,.640,0,0,,114,178,.640,.640,29,56,.518,77,120,197,69,18,20,48,46,257
Aleksej Pokusevski,PF,21,OKC,21,16,469,78,170,.459,26,70,.371,52,100,.520,.535,13,21,.619,36,68,104,35,13,31,29,38,195
Jordan Poole,SG,23,GSW,25,6,688,149,342,.436,60,180,.333,89,162,.549,.523,66,79,.835,7,44,51,112,21,8,73,57,424
Kevin Porter Jr.,PG,22,HOU,23,23,799,147,355,.414,48,137,.350,99,218,.454,.482,96,126,.762,34,98,132,134,29,10,89,68,438
Michael Porter Jr.,SF,24,DEN,16,16,465,96,206,.466,47,110,.427,49,96,.510,.580,24,30,.800,19,77,96,20,10,6,18,42,263
Otto Porter Jr.,SF,29,TOR,8,2,146,15,30,.500,6,17,.353,9,13,.692,.600,8,8,1.000,6,13,19,8,11,0,4,7,44
Bobby Portis,PF,27,MIL,23,7,618,134,275,.487,28,87,.322,106,188,.564,.538,23,30,.767,56,183,239,54,8,8,27,44,319
Kristaps Porziņģis,PF,27,WAS,23,23,747,169,361,.468,48,135,.356,121,226,.535,.535,116,146,.795,51,152,203,58,19,35,42,74,502
Micah Potter,PF,24,UTA,2,0,12,2,2,1.000,0,0,,2,2,1.000,1.000,0,0,,1,2,3,1,0,0,0,2,4
Dwight Powell,C,31,DAL,20,16,342,44,64,.688,0,1,.000,44,63,.698,.688,27,41,.659,35,32,67,10,11,8,17,49,115
Norman Powell,SG,29,LAC,22,5,556,113,246,.459,36,95,.379,77,151,.510,.533,64,82,.780,9,55,64,33,18,7,39,40,326
Jason Preston,PG,23,LAC,4,0,27,6,13,.462,2,7,.286,4,6,.667,.538,0,2,.000,1,2,3,5,0,0,2,2,14
Joshua Primo,SG,20,SAS,4,0,93,9,26,.346,3,12,.250,6,14,.429,.404,7,9,.778,2,11,13,18,1,2,11,8,28
Taurean Prince,SF,28,MIN,18,0,352,51,103,.495,21,54,.389,30,49,.612,.597,19,22,.864,6,39,45,21,6,4,21,43,142
Payton Pritchard,PG,25,BOS,14,0,171,28,68,.412,14,38,.368,14,30,.467,.515,5,8,.625,8,14,22,16,5,1,12,6,75
Trevelin Queen,PG,25,IND,2,0,20,0,3,.000,0,3,.000,0,0,,.000,0,0,,1,2,3,2,1,1,3,1,0
Immanuel Quickley,PG,23,NYK,24,0,548,83,200,.415,28,91,.308,55,109,.505,.485,47,56,.839,16,91,107,72,24,3,35,43,241
Julius Randle,PF,28,NYK,24,24,796,175,380,.461,51,157,.325,124,223,.556,.528,106,136,.779,51,152,203,83,17,4,66,77,507
Austin Reaves,SG,24,LAL,22,8,632,71,133,.534,24,62,.387,47,71,.662,.624,63,69,.913,16,55,71,44,9,7,22,31,229
Cam Reddish,SF,23,NYK,20,8,438,61,136,.449,17,56,.304,44,80,.550,.511,29,33,.879,7,24,31,20,15,8,15,32,168
Davon Reed,SG,27,DEN,18,1,199,16,53,.302,11,30,.367,5,23,.217,.406,8,10,.800,4,24,28,9,5,2,12,21,51
Paul Reed,C,23,PHI,21,0,256,32,55,.582,0,3,.000,32,52,.615,.582,8,12,.667,30,54,84,12,22,16,16,52,72
Naz Reid,C,23,MIN,17,0,246,54,103,.524,11,38,.289,43,65,.662,.578,16,25,.640,10,49,59,13,5,17,12,40,135
Nick Richards,C,25,CHO,24,0,463,88,142,.620,0,0,,88,142,.620,.620,54,74,.730,74,90,164,16,2,18,22,53,230
Josh Richardson,SG,29,SAS,17,2,388,59,146,.404,29,80,.363,30,66,.455,.503,27,32,.844,7,31,38,51,12,2,29,31,174
Austin Rivers,SG,30,MIN,13,2,169,11,31,.355,4,20,.200,7,11,.636,.419,12,13,.923,0,14,14,8,2,1,6,13,38
Duncan Robinson,SF,28,MIA,17,0,293,36,100,.360,23,73,.315,13,27,.481,.475,9,10,.900,4,31,35,21,4,0,11,32,104
Mitchell Robinson,C,24,NYK,16,15,374,50,69,.725,0,0,,50,69,.725,.725,13,31,.419,58,64,122,12,10,31,10,50,113
Orlando Robinson,C,22,MIA,2,0,40,6,13,.462,0,3,.000,6,10,.600,.462,2,3,.667,2,7,9,1,2,1,1,5,14
Jeremiah Robinson-Earl,PF,22,OKC,23,16,490,77,155,.497,28,70,.400,49,85,.576,.587,20,26,.769,43,72,115,22,19,10,14,44,202
Isaiah Roby,PF,24,SAS,19,0,254,36,81,.444,12,35,.343,24,46,.522,.519,8,18,.444,8,44,52,26,9,6,11,26,92
David Roddy,PF,21,MEM,24,1,464,54,141,.383,23,76,.303,31,65,.477,.465,15,21,.714,17,48,65,15,8,7,16,36,146
Ryan Rollins,PG,20,GSW,7,0,43,5,15,.333,3,8,.375,2,7,.286,.433,2,2,1.000,1,6,7,3,0,0,12,9,15
Derrick Rose,PG,34,NYK,21,0,285,54,135,.400,17,49,.347,37,86,.430,.463,10,10,1.000,8,29,37,42,7,5,17,14,135
Terrence Ross,SG,31,ORL,22,8,538,76,178,.427,37,94,.394,39,84,.464,.531,9,13,.692,7,42,49,29,16,4,27,33,198
Terry Rozier,PG,28,CHO,16,16,597,129,335,.385,40,133,.301,89,202,.441,.445,42,50,.840,21,55,76,93,12,3,42,31,340
D'Angelo Russell,PG,26,MIN,23,23,724,127,291,.436,44,138,.319,83,153,.542,.512,46,59,.780,15,62,77,154,30,13,63,47,344
Matt Ryan,SF,25,LAL,12,0,129,15,49,.306,13,35,.371,2,14,.143,.439,4,5,.800,2,12,14,4,2,0,3,14,47
Domantas Sabonis,PF,26,SAC,22,22,705,133,222,.599,10,27,.370,123,195,.631,.622,92,122,.754,48,193,241,144,16,11,55,84,368
Dario Šarić,PF,28,PHO,11,2,134,16,44,.364,7,20,.350,9,24,.375,.443,5,7,.714,15,24,39,12,3,2,6,21,44
Jordan Schakel,SF,24,WAS,2,0,6,1,2,.500,1,1,1.000,0,1,.000,.750,0,0,,0,0,0,1,1,0,0,1,3
Admiral Schofield,PF,25,ORL,14,0,168,21,46,.457,11,29,.379,10,17,.588,.576,6,6,1.000,9,11,20,9,2,2,4,29,59
Dennis Schröder,PG,29,LAL,8,5,207,21,53,.396,5,16,.313,16,37,.432,.443,16,18,.889,1,13,14,33,6,0,9,13,63
Dereon Seabron,SG,22,NOP,2,0,3,0,0,,0,0,,0,0,,,0,0,,0,0,0,0,0,0,0,0,0
Alperen Şengün,C,20,HOU,21,18,562,120,216,.556,4,21,.190,116,195,.595,.565,68,86,.791,71,109,180,46,16,20,49,74,312
Collin Sexton,SG,24,UTA,26,9,634,128,259,.494,24,66,.364,104,193,.539,.541,90,108,.833,22,42,64,77,16,2,47,59,370
Landry Shamet,SG,25,PHO,15,0,249,35,86,.407,24,62,.387,11,24,.458,.547,17,19,.895,4,10,14,18,7,2,16,22,111
Day'Ron Sharpe,C,21,BRK,15,0,113,15,31,.484,3,4,.750,12,27,.444,.532,8,12,.667,13,30,43,9,3,7,8,24,41
Shaedon Sharpe,SG,19,POR,23,5,462,75,160,.469,21,56,.375,54,104,.519,.534,14,23,.609,16,40,56,11,7,5,17,38,185
Pascal Siakam,C,28,TOR,14,14,486,121,247,.490,19,53,.358,102,194,.526,.528,82,109,.752,24,100,124,99,14,7,34,45,343
Ben Simmons,PG,26,BRK,17,12,477,62,101,.614,0,1,.000,62,100,.620,.614,18,33,.545,17,96,113,99,21,12,39,64,142
Marko Simonovic,C,23,CHI,1,0,2,0,1,.000,0,1,.000,0,0,,.000,0,0,,0,0,0,0,0,0,0,0,0
Anfernee Simons,SG,23,POR,22,22,817,187,422,.443,93,234,.397,94,188,.500,.553,76,85,.894,7,60,67,100,22,6,48,49,543
Jericho Sims,C,24,NYK,16,2,217,32,42,.762,0,0,,32,42,.762,.762,8,10,.800,34,42,76,7,5,15,7,32,72
Marcus Smart,PG,28,BOS,22,22,729,96,212,.453,41,115,.357,55,97,.567,.550,33,43,.767,9,60,69,168,25,7,49,66,266
Dennis Smith Jr.,PG,25,CHO,15,11,419,62,134,.463,10,30,.333,52,104,.500,.500,6,12,.500,9,40,49,85,27,10,23,34,140
Dru Smith,SG,25,MIA,3,0,42,4,9,.444,1,3,.333,3,6,.500,.500,0,0,,0,7,7,2,3,3,1,6,9
Ish Smith,PG,34,DEN,10,0,120,17,43,.395,2,6,.333,15,37,.405,.419,1,2,.500,1,12,13,25,3,6,12,9,37
Jabari Smith Jr.,PF,19,HOU,23,23,694,90,245,.367,49,138,.355,41,107,.383,.467,43,51,.843,29,133,162,17,8,22,26,76,272
Jalen Smith,PF,22,IND,24,24,563,100,223,.448,29,98,.296,71,125,.568,.513,45,58,.776,45,121,166,27,6,25,30,53,274
Jeremy Sochan,PF,19,SAS,20,20,497,71,150,.473,8,44,.182,63,106,.594,.500,11,20,.550,26,55,81,40,19,10,31,52,161
Jaden Springer,PG,20,PHI,2,0,4,2,3,.667,0,0,,2,3,.667,.667,1,2,.500,1,1,2,0,0,1,0,1,5
Lamar Stevens,PF,25,CLE,11,8,236,29,63,.460,7,17,.412,22,46,.478,.516,16,19,.842,7,24,31,4,4,6,6,16,81
Isaiah Stewart,C,21,DET,18,18,495,70,152,.461,26,72,.361,44,80,.550,.546,50,67,.746,47,114,161,24,8,14,19,53,216
Max Strus,SF,26,MIA,22,13,727,114,270,.422,65,183,.355,49,87,.563,.543,30,35,.857,12,65,77,37,20,7,26,51,323
Jalen Suggs,PG,21,ORL,14,13,405,65,155,.419,20,68,.294,45,87,.517,.484,23,35,.657,15,31,46,76,22,9,47,44,173
Edmond Sumner,SG,27,BRK,20,8,306,49,112,.438,12,44,.273,37,68,.544,.491,33,36,.917,5,21,26,23,20,5,22,28,143
Cole Swider,SF,23,LAL,1,0,2,0,1,.000,0,1,.000,0,0,,.000,0,0,,0,1,1,1,0,0,0,0,0
Jae'Sean Tate,SF,27,HOU,3,2,68,10,20,.500,2,5,.400,8,15,.533,.550,3,4,.750,8,5,13,10,3,0,5,15,25
Jayson Tatum,PF,24,BOS,24,24,887,242,504,.480,82,225,.364,160,279,.573,.562,172,198,.869,27,172,199,101,24,25,66,54,738
Terry Taylor,SG,23,IND,15,2,128,11,31,.355,2,10,.200,9,21,.429,.387,4,5,.800,9,13,22,6,2,4,4,13,28
Garrett Temple,SG,36,NOP,9,0,70,9,22,.409,5,13,.385,4,9,.444,.523,3,4,.750,1,5,6,3,6,1,3,6,26
Dalen Terry,SG,20,CHI,10,0,33,3,11,.273,1,4,.250,2,7,.286,.318,3,4,.750,0,2,2,5,1,2,4,2,10
Cam Thomas,SG,21,BRK,19,0,283,37,101,.366,7,25,.280,30,76,.395,.401,40,50,.800,1,24,25,29,9,3,15,19,121
Klay Thompson,SG,32,GSW,20,20,607,127,316,.402,78,200,.390,49,116,.422,.525,28,33,.848,10,61,71,49,12,7,32,35,360
JT Thor,PF,20,CHO,14,0,146,12,38,.316,4,20,.200,8,18,.444,.368,7,9,.778,8,21,29,8,3,5,9,8,35
Matisse Thybulle,SG,25,PHI,20,3,228,12,39,.308,5,23,.217,7,16,.438,.372,1,3,.333,6,18,24,8,16,5,3,23,30
Xavier Tillman Sr.,PF,24,MEM,11,0,127,17,33,.515,2,6,.333,15,27,.556,.545,4,12,.333,15,16,31,8,4,5,7,13,40
Isaiah Todd,PF,21,WAS,4,0,13,1,4,.250,0,3,.000,1,1,1.000,.250,0,0,,0,0,0,0,0,0,0,0,2
Obi Toppin,PF,24,NYK,24,0,421,71,168,.423,33,94,.351,38,74,.514,.521,14,17,.824,14,79,93,26,10,5,19,28,189
Juan Toscano-Anderson,SF,29,LAL,12,0,127,10,25,.400,2,11,.182,8,14,.571,.440,4,5,.800,1,21,22,6,3,3,8,17,26
Karl-Anthony Towns,PF,27,MIN,21,21,709,153,303,.505,38,117,.325,115,186,.618,.568,92,104,.885,35,137,172,111,16,14,65,82,436
Gary Trent Jr.,SG,24,TOR,21,16,646,121,286,.423,47,140,.336,74,146,.507,.505,61,79,.772,13,29,42,32,34,3,23,29,350
P.J. Tucker,PF,37,PHI,24,24,687,32,71,.451,15,38,.395,17,33,.515,.556,4,6,.667,30,74,104,24,14,7,23,63,83
Myles Turner,C,26,IND,19,18,519,111,204,.544,28,71,.394,83,133,.624,.613,66,81,.815,27,119,146,27,10,43,33,60,316
Jonas Valančiūnas,C,30,NOP,23,23,530,117,211,.555,15,36,.417,102,175,.583,.590,59,71,.831,60,147,207,46,7,8,44,57,308
Jarred Vanderbilt,PF,23,UTA,24,24,598,87,143,.608,12,26,.462,75,117,.641,.650,20,32,.625,55,143,198,66,28,6,39,69,206
Fred VanVleet,PG,28,TOR,18,18,659,95,266,.357,50,147,.340,45,119,.378,.451,54,64,.844,9,55,64,115,30,9,33,50,294
Devin Vassell,SG,22,SAS,19,17,618,142,311,.457,59,141,.418,83,170,.488,.551,47,58,.810,4,76,80,68,14,8,30,29,390
Gabe Vincent,PG,26,MIA,19,0,472,60,154,.390,27,91,.297,33,63,.524,.477,21,25,.840,5,34,39,56,16,2,26,49,168
Noah Vonleh,C,27,BOS,16,1,142,11,22,.500,1,3,.333,10,19,.526,.523,2,2,1.000,17,23,40,5,2,6,10,29,25
Nikola Vučević,C,32,CHI,23,23,736,140,293,.478,36,104,.346,104,189,.550,.539,47,55,.855,51,201,252,65,11,17,47,47,363
Dean Wade,PF,26,CLE,17,9,409,38,84,.452,23,56,.411,15,28,.536,.589,9,13,.692,10,59,69,17,12,6,7,42,108
Franz Wagner,SF,21,ORL,25,25,829,179,361,.496,33,101,.327,146,260,.562,.542,91,105,.867,20,82,102,94,19,6,69,63,482
Moritz Wagner,C,25,ORL,7,3,170,24,51,.471,3,22,.136,21,29,.724,.500,19,23,.826,13,34,47,18,4,2,14,26,70
Ish Wainright,SF,28,PHO,9,1,124,13,28,.464,12,24,.500,1,4,.250,.679,2,3,.667,9,9,18,10,5,2,3,16,40
Jabari Walker,SF,20,POR,13,0,105,10,26,.385,1,8,.125,9,18,.500,.404,4,6,.667,7,22,29,9,1,2,4,11,25
Lonnie Walker IV,SG,24,LAL,19,19,594,117,242,.483,39,100,.390,78,142,.549,.564,44,51,.863,7,37,44,33,17,8,20,33,317
John Wall,PG,32,LAC,20,0,442,90,207,.435,18,66,.273,72,141,.511,.478,58,87,.667,6,46,52,113,18,5,47,34,256
T.J. Warren,SF,29,BRK,2,0,35,6,15,.400,0,2,.000,6,13,.462,.400,2,2,1.000,4,2,6,1,1,1,1,2,14
Duane Washington Jr.,SG,22,PHO,15,0,135,29,77,.377,11,39,.282,18,38,.474,.448,0,2,.000,0,9,9,11,1,1,9,7,69
P.J. Washington,PF,24,CHO,24,24,774,141,330,.427,48,139,.345,93,191,.487,.500,51,63,.810,26,87,113,54,18,24,45,61,381
TyTy Washington Jr.,PG,21,HOU,1,0,4,0,0,,0,0,,0,0,,,1,2,.500,0,0,0,0,0,0,0,0,1
Yuta Watanabe,SF,28,BRK,14,0,255,42,69,.609,24,42,.571,18,27,.667,.783,6,9,.667,10,31,41,13,3,7,5,16,114
Lindy Waters III,SG,25,OKC,5,0,69,8,23,.348,7,22,.318,1,1,1.000,.500,0,0,,2,8,10,2,3,0,0,5,23
Trendon Watford,PF,22,POR,15,2,279,31,55,.564,3,10,.300,28,45,.622,.591,17,19,.895,13,48,61,25,7,1,16,28,82
Peyton Watson,SG,20,DEN,6,0,15,3,9,.333,0,1,.000,3,8,.375,.333,0,0,,2,1,3,0,0,0,0,1,6
Blake Wesley,SG,19,SAS,2,0,23,6,9,.667,2,3,.667,4,6,.667,.778,2,4,.500,1,1,2,4,0,0,2,3,16
Russell Westbrook,PG,34,LAL,21,3,588,112,277,.404,26,85,.306,86,192,.448,.451,56,82,.683,21,91,112,162,20,8,74,51,306
Coby White,PG,22,CHI,15,0,278,41,100,.410,21,64,.328,20,36,.556,.515,9,13,.692,2,28,30,24,9,2,13,24,112
Derrick White,SG,28,BOS,25,20,655,90,192,.469,46,106,.434,44,86,.512,.589,43,48,.896,14,61,75,83,21,17,24,64,269
Jack White,SF,25,DEN,8,0,26,1,6,.167,0,2,.000,1,4,.250,.167,0,0,,2,3,5,0,1,2,0,4,2
Aaron Wiggins,SG,24,OKC,17,5,330,37,80,.463,13,33,.394,24,47,.511,.544,16,20,.800,17,44,61,29,9,4,11,26,103
Andrew Wiggins,SF,27,GSW,22,22,722,163,319,.511,67,149,.450,96,170,.565,.616,27,43,.628,34,79,113,48,30,17,30,64,420
Grant Williams,PF,24,BOS,24,11,695,77,144,.535,41,90,.456,36,54,.667,.677,24,28,.857,20,90,110,45,18,10,20,68,219
Jalen Williams,SG,21,OKC,20,8,511,87,163,.534,14,46,.304,73,117,.624,.577,28,35,.800,12,54,66,50,12,7,31,53,216
Jaylin Williams,PF,20,OKC,5,0,35,5,11,.455,0,2,.000,5,9,.556,.455,4,6,.667,5,5,10,3,1,0,2,6,14
Kenrich Williams,PF,28,OKC,21,3,429,59,112,.527,14,38,.368,45,74,.608,.589,6,14,.429,35,45,80,29,13,4,8,40,138
Mark Williams,C,21,CHO,3,0,13,4,7,.571,0,0,,4,7,.571,.571,3,3,1.000,4,4,8,0,0,0,2,3,11
Patrick Williams,PF,21,CHI,23,22,596,77,171,.450,29,69,.420,48,102,.471,.535,27,29,.931,26,66,92,18,16,23,36,48,210
Vince Williams Jr.,SG,22,MEM,6,0,40,3,11,.273,1,8,.125,2,3,.667,.318,0,0,,1,4,5,2,4,1,0,5,7
Zion Williamson,PF,22,NOP,18,18,576,163,276,.591,3,11,.273,160,265,.604,.596,96,132,.727,38,89,127,77,23,11,49,41,425
Justise Winslow,SF,26,POR,21,10,610,66,162,.407,11,35,.314,55,127,.433,.441,18,26,.692,35,80,115,78,24,9,34,65,161
James Wiseman,C,21,GSW,11,0,147,30,51,.588,0,0,,30,51,.588,.588,15,23,.652,11,31,42,11,1,4,8,26,75
Christian Wood,PF,27,DAL,20,0,521,125,226,.553,28,68,.412,97,158,.614,.615,59,87,.678,25,130,155,27,8,11,50,57,337
Delon Wright,PG,30,WAS,4,0,91,10,24,.417,3,12,.250,7,12,.583,.479,3,5,.600,4,6,10,13,11,4,4,5,26
McKinley Wright IV,PG,24,DAL,1,0,5,1,4,.250,0,1,.000,1,3,.333,.250,0,0,,1,1,2,2,1,0,0,0,2
Thaddeus Young,PF,34,TOR,21,8,359,50,94,.532,3,15,.200,47,79,.595,.548,12,14,.857,38,46,84,39,21,2,18,35,115
Trae Young,PG,24,ATL,22,22,781,194,476,.408,48,162,.296,146,314,.465,.458,171,190,.900,17,47,64,212,16,3,76,30,607
Ivica Zubac,C,25,LAC,25,25,761,106,169,.627,0,1,.000,106,168,.631,.627,55,81,.679,87,200,287,31,11,43,55,75,267
